111111
10C001
1000P1
10CE01
100001
100001
100001
111111
